1010101010101010101010101010101010
1030404040404040404040404040404010
1040404040404040404040404040404010
1040404040404040404040404040404010
1040404040404040404040404040404010
1040404040404040404040404040404010
1040404040404040404040404040404010
1040404040404040404040404040404010
1040404040404040404040404040404010
1010101010101010101010101010101010
