2020202020202020202020202020202020
2080808080808080808080808080808020
2080808080808080O48080808080808020
2080808080808080C48080808044808020
2080808080808080808080808080808020
2080808080808080808080808080808020
2080808080808080808080808080808020
2080808080808080808080808080808020
2080808080808080808080808080808020
2020202020202020202020202020202020
