1010101010101010101010101010101010
10C0C0C088888888C0C0A288888888A210
10C088C088888888C0C0C088888888C010
10C088C08888888888888888888888C010
10C088C088C0C0C088C0C0C088C0C0C010
10C088C088C088C088C088C088C0888810
10C088C088C088C088C088C088C0888810
10C088C088C088C088C088C088C0888810
10C088C0C0C088C0C0C088C0C0C0888810
1010101010101010101010101010101010