1010101010101010101010101010101010
10E1E1E140404040404040404040404010
10E1E1E1E1E14040404040404040404010
10404040E1E1E1E1E1E1E1E1E1E1404010
104040404040E1E1E1E1404040E1E1E110
1040404040404040E1E140404040404010
10E1E1404040404040E1E1404040404010
10E1E1404040404040E1E1E1E140404010
1040E1404040404040E14040E1E1404010
1010101010101010101010101010101010