2020202020202020202020202020202020
20S2S2S280808080808080808080808020
20S2S2S2S2S28080808080808080808020
20808080S2S2S2S2S2S2S2S2S2S2808020
208080808080S2S2S2S2808080S2S2S220
2091808080808080S2S280808080808020
20S2S2808080808080S2S2808080808020
20S2S2808080808080S2S2S2S280808020
2080S2808080808080S28080S2S2808020
2020202020202020202020202020202020